###################
###################
###################
###################
###################
###################
###################
#!-----###-------@#
######-###-########
######-###-########
######-###-########
######-###-########
######-----########
###################
###################