###################
###################
###########S---####
##############-####
##############-####
#######E######-####
#####===######-####
#!---===##-------@#
######-###-##-#####
######-###-##=#####
######-###-##=#####
######-###-##=#####
######----=P==#####
###################
###################