###################
###################
###################
###################
###################
###################
#####===###########
#!---===##-------@#
######-###-##-#####
######-###-##=#####
######-###-##=#####
######-###-##=#####
######----====#####
###################
###################