###################
###################
###########S---####
##############M####
##############-####
#######E######-####
#####===######-####
#!---===##-------@#
######-###-##-#####
######-###-##=#####
######-###-##=#####
######-###-##=#####
######--M-=P==#####
###################
###################